ffffffff800000001000000000000a00
0c000600050008000a00000000010400
0c000000080008000000040008000000
04000000010000001400000010001400
0800060007000c000000100010000000
00000102100000002000000004000000
00000000070000006e756d6265727300
08000c00080007000800000000000001
